28
21
OOOOOOOOOOOOOOOOOOOOOOOOOOOO
OOOOOOOOOOOOOEOOOOOOOOOOOOOO
122223OOOOOOOOOOPOOOOOOOOOOO
OOOOOOOOOOOOOOOO1223OOOOOOOO
OOOOOOOOOOOOOOOOOOOOOOEOOOOO
OOOOOOOOOOOOOOOOOOOOOOOOOOOO
OOOOOO122223OOOOOOOOOOOOOOOO
2OOOOOOOOOOOOOOOOOOO123OOOOO
5OOEOOOOOOO0OOOOOOOOOOOOOOO
5OOOOOOOOOO0OOOOOOOOOOOOOOOO
9OOOOOOOOOO2OOOOOOOOOOOOOOOO
OOOPOOOOOOOOOOOOOOOOOOOOOOOO
OO123OOOOOOOO12222223OOOOOOO
OOOOO12223OOOOOOOOOOOOOOOOOO
OOOOOOOOOOOOOOOOOOOOOOOOEOOO
OOOOOOOOOOOOOOOOOOOOOOOOOOOO
OOO12223OOOOOOOOOOOOOOOOOOOO
OOOOOOOOOOOOOOOOPOOOOOOOOOOO
OOOOOOOOOOOOOO1223OOOOOOOOOO
OOOOOOOOOOOOOOOOOOOOOOOPOOOO
OOOOOO122223OOOOOOOOOO1223OO